FW  FNW  FB   FW FW FW 
D1   G   SC1  FW FW FW
FZ   O   D2   FW FW FW
FW  FW   FW   FW FW FW
FW  FW   FW   FW FW FW
FW  FW   FW   FW FW FW